x x x x x x x x x x
x o x o o o x m o 0
x o x x x s x o o x
x o o o x o x o o x
x x x o o o x x o x
x o x x x o o o o x
x o x x x o x b o x
x o x x x x x x o x
x x x o o o o x o x
x o o o o s o o o x
x o x o o o o x x x
x 0 x x x x x x x x 
