x x x x x x x x x x
x o o o o o o o s x
x x x o x x x o x x
x l x o x l x o x x
x x x o x x x o x x
x o o o o o o o o x
x o x x x x x x x x
x o x l x l x l x x
x o x x x x x x x x
x o o o x o o o x x
x b x o o o x o x x
x x x x x x x 0 x x
